12
12
4 4 3 4 4 1 3 4 4 1 3 4
4 0 1 3 4 4 3 1 4 1 4 4
3 4 4 4 3 4 4 4 1 4 4 1
4 4 3 4 4 4 2 4 4 4 4 1
4 4 4 4 4 1 4 1 4 4 2 2
1 4 4 4 4 4 4 4 4 3 4 3
1 1 4 4 3 4 4 4 4 1 4 1
4 4 4 1 4 1 4 4 4 4 4 1
1 4 4 1 4 3 4 4 4 4 4 3
4 4 1 4 1 4 4 1 4 4 4 2
4 3 4 1 4 3 4 1 1 4 4 4
4 4 4 4 4 4 1 4 3 4 4 1