8
8
1 1 3 1 1 3 1 1
1 0 1 3 4 1 3 1
3 1 1 4 3 1 1 1
1 4 3 2 1 1 2 1
1 1 2 1 4 1 4 1
1 3 1 1 1 1 1 2
1 1 1 1 3 4 2 2
1 3 1 1 4 1 1 1